01,01,01,01,01,01,01,01,01,01,01,01,01,01,01,01,01,01,01,01,01,01
01,01,01,01,01,01,01,02,02,02,02,02,02,01,01,01,01,01,01,01,01,01
01,01,01,01,01,02,02,02,00,00,00,00,02,02,01,01,01,01,01,01,01,01
01,01,01,01,02,00,00,00,00,00,00,00,00,02,02,01,01,01,01,01,01,01
01,01,01,01,02,00,00,00,00,00,00,00,00,00,02,01,01,01,01,01,01,01
01,01,01,01,02,00,00,00,00,00,00,00,00,00,02,01,01,01,01,01,01,01
01,01,01,01,02,00,00,00,00,00,00,00,00,00,02,01,01,01,01,01,01,01
01,01,01,01,02,00,00,00,00,00,00,00,00,00,02,01,01,01,01,01,01,01
01,01,01,01,02,00,00,00,00,00,00,00,00,00,02,01,01,01,01,01,01,01
01,01,01,02,02,00,00,00,00,00,00,00,00,00,02,01,01,01,01,01,01,01
01,01,01,02,00,00,00,00,00,00,00,00,00,02,02,01,01,01,01,01,01,01
01,01,01,02,00,00,00,00,00,00,00,00,00,02,01,01,01,01,01,01,01,01
01,01,01,02,02,02,00,00,00,00,00,00,00,02,01,01,01,01,01,01,01,01
01,01,01,01,01,02,02,02,02,00,00,00,02,02,01,01,01,01,01,01,01,01
01,01,01,01,01,01,01,01,02,02,02,02,02,01,01,01,01,01,01,01,01,01
01,01,01,01,01,01,01,01,01,01,01,01,01,01,01,01,01,01,01,01,01,01

0,0,0,0,0,0,0,0,0,0,0,0,0,0,0,0,0,0,0,0,0,0
0,0,0,0,0,0,0,1,1,1,1,1,1,0,0,0,0,0,0,0,0,0
0,0,0,0,0,1,1,1,0,0,0,0,1,1,0,0,0,0,0,0,0,0
0,0,0,0,1,0,0,0,0,0,0,0,0,1,1,0,0,0,0,0,0,0
0,0,0,0,1,0,0,0,0,0,0,0,0,0,1,0,0,0,0,0,0,0
0,0,0,0,1,0,0,0,0,0,0,0,0,0,1,0,0,0,0,0,0,0
0,0,0,0,1,0,0,0,0,0,0,0,0,0,1,0,0,0,0,0,0,0
0,0,0,0,1,0,0,0,0,0,0,0,0,0,1,0,0,0,0,0,0,0
0,0,0,0,1,0,0,0,0,0,0,0,0,0,1,0,0,0,0,0,0,0
0,0,0,1,1,0,0,0,0,0,0,0,0,0,1,0,0,0,0,0,0,0
0,0,0,1,0,0,0,0,0,0,0,0,0,1,1,0,0,0,0,0,0,0
0,0,0,1,0,0,0,0,0,0,0,0,0,1,0,0,0,0,0,0,0,0
0,0,0,1,1,1,0,0,0,0,0,0,0,1,0,0,0,0,0,0,0,0
0,0,0,0,0,1,1,1,1,0,0,0,1,1,0,0,0,0,0,0,0,0
0,0,0,0,0,0,0,0,1,1,1,1,1,0,0,0,0,0,0,0,0,0
0,0,0,0,0,0,0,0,0,0,0,0,0,0,0,0,0,0,0,0,0,0